[console_scripts]
ironic-collect-introspection-data = ironic_python_agent.cmd.inspect:run
ironic-python-agent = ironic_python_agent.cmd.agent:run

[ironic_python_agent.extensions]
clean = ironic_python_agent.extensions.clean:CleanExtension
deploy = ironic_python_agent.extensions.deploy:DeployExtension
flow = ironic_python_agent.extensions.flow:FlowExtension
image = ironic_python_agent.extensions.image:ImageExtension
log = ironic_python_agent.extensions.log:LogExtension
poll = ironic_python_agent.extensions.poll:PollExtension
rescue = ironic_python_agent.extensions.rescue:RescueExtension
service = ironic_python_agent.extensions.service:ServiceExtension
standby = ironic_python_agent.extensions.standby:StandbyExtension
system = ironic_python_agent.extensions.system:SystemExtension

[ironic_python_agent.hardware_managers]
cna = ironic_python_agent.hardware_managers.cna:IntelCnaHardwareManager
container = ironic_python_agent.hardware_managers.container:ContainerHardwareManager
generic = ironic_python_agent.hardware:GenericHardwareManager
mlnx = ironic_python_agent.hardware_managers.mlnx:MellanoxDeviceHardwareManager

[ironic_python_agent.inspector.collectors]
default = ironic_python_agent.inspector:collect_default
dmi-decode = ironic_python_agent.dmi_inspector:collect_dmidecode_info
extra-hardware = ironic_python_agent.inspector:collect_extra_hardware
lldp = ironic_python_agent.inspector:collect_lldp
logs = ironic_python_agent.inspector:collect_logs
numa-topology = ironic_python_agent.numa_inspector:collect_numa_topology_info
pci-devices = ironic_python_agent.inspector:collect_pci_devices_info
usb-devices = ironic_python_agent.inspector:collect_usb_devices

[oslo.config.opts]
ironic-python-agent = ironic_python_agent.config:list_opts
ironic-python-agent-mdns = ironic_python_agent.mdns:list_opts
