[console_scripts]
datahub = datahub.entrypoints:main

[datahub.fs.plugins]
file = datahub.ingestion.fs.local_fs:LocalFileSystem
http = datahub.ingestion.fs.http_fs:HttpFileSystem
s3 = datahub.ingestion.fs.s3_fs:S3FileSystem

[datahub.ingestion.checkpointing_provider.plugins]
datahub = datahub.ingestion.source.state_provider.datahub_ingestion_checkpointing_provider:DatahubIngestionCheckpointingProvider
file = datahub.ingestion.source.state_provider.file_ingestion_checkpointing_provider:FileIngestionCheckpointingProvider

[datahub.ingestion.reporting_provider.plugins]
datahub = datahub.ingestion.reporting.datahub_ingestion_run_summary_provider:DatahubIngestionRunSummaryProvider
file = datahub.ingestion.reporting.file_reporter:FileReporter

[datahub.ingestion.sink.plugins]
blackhole = datahub.ingestion.sink.blackhole:BlackHoleSink
console = datahub.ingestion.sink.console:ConsoleSink
datahub-kafka = datahub.ingestion.sink.datahub_kafka:DatahubKafkaSink
datahub-lite = datahub.ingestion.sink.datahub_lite:DataHubLiteSink
datahub-rest = datahub.ingestion.sink.datahub_rest:DatahubRestSink
file = datahub.ingestion.sink.file:FileSink

[datahub.ingestion.source.plugins]
abs = datahub.ingestion.source.abs.source:ABSSource
athena = datahub.ingestion.source.sql.athena:AthenaSource
azure-ad = datahub.ingestion.source.identity.azure_ad:AzureADSource
azure-data-factory = datahub.ingestion.source.azure_data_factory.adf_source:AzureDataFactorySource
bigquery = datahub.ingestion.source.bigquery_v2.bigquery:BigqueryV2Source
bigquery-queries = datahub.ingestion.source.bigquery_v2.bigquery_queries:BigQueryQueriesSource
cassandra = datahub.ingestion.source.cassandra.cassandra:CassandraSource
clickhouse = datahub.ingestion.source.sql.clickhouse:ClickHouseSource
clickhouse-usage = datahub.ingestion.source.usage.clickhouse_usage:ClickHouseUsageSource
cockroachdb = datahub.ingestion.source.sql.cockroachdb:CockroachDBSource
csv-enricher = datahub.ingestion.source.csv_enricher:CSVEnricherSource
datahub = datahub.ingestion.source.datahub.datahub_source:DataHubSource
datahub-apply = datahub.ingestion.source.apply.datahub_apply:DataHubApplySource
datahub-business-glossary = datahub.ingestion.source.metadata.business_glossary:BusinessGlossaryFileSource
datahub-debug = datahub.ingestion.source.debug.datahub_debug:DataHubDebugSource
datahub-documents = datahub.ingestion.source.datahub_documents.datahub_documents_source:DataHubDocumentsSource
datahub-gc = datahub.ingestion.source.gc.datahub_gc:DataHubGcSource
datahub-lineage-file = datahub.ingestion.source.metadata.lineage:LineageFileSource
datahub-mock-data = datahub.ingestion.source.mock_data.datahub_mock_data:DataHubMockDataSource
dataplex = datahub.ingestion.source.dataplex.dataplex:DataplexSource
db2 = datahub.ingestion.source.sql.db2:Db2Source
dbt = datahub.ingestion.source.dbt.dbt_core:DBTCoreSource
dbt-cloud = datahub.ingestion.source.dbt.dbt_cloud:DBTCloudSource
delta-lake = datahub.ingestion.source.delta_lake:DeltaLakeSource
demo-data = datahub.ingestion.source.demo_data.DemoDataSource
dremio = datahub.ingestion.source.dremio.dremio_source:DremioSource
druid = datahub.ingestion.source.sql.druid:DruidSource
dynamodb = datahub.ingestion.source.dynamodb.dynamodb:DynamoDBSource
elasticsearch = datahub.ingestion.source.elastic_search:ElasticsearchSource
excel = datahub.ingestion.source.excel.source:ExcelSource
fabric-onelake = datahub.ingestion.source.fabric.onelake.source:FabricOneLakeSource
feast = datahub.ingestion.source.feast:FeastRepositorySource
file = datahub.ingestion.source.file:GenericFileSource
fivetran = datahub.ingestion.source.fivetran.fivetran:FivetranSource
gcs = datahub.ingestion.source.gcs.gcs_source:GCSSource
glue = datahub.ingestion.source.aws.glue:GlueSource
grafana = datahub.ingestion.source.grafana.grafana_source:GrafanaSource
hana = datahub.ingestion.source.sql.hana:HanaSource
hex = datahub.ingestion.source.hex.hex:HexSource
hive = datahub.ingestion.source.sql.hive.hive_source:HiveSource
hive-metastore = datahub.ingestion.source.sql.hive.hive_metastore_source:HiveMetastoreSource
iceberg = datahub.ingestion.source.iceberg.iceberg:IcebergSource
json-schema = datahub.ingestion.source.schema.json_schema:JsonSchemaSource
kafka = datahub.ingestion.source.kafka.kafka:KafkaSource
kafka-connect = datahub.ingestion.source.kafka_connect.kafka_connect:KafkaConnectSource
ldap = datahub.ingestion.source.ldap:LDAPSource
looker = datahub.ingestion.source.looker.looker_source:LookerDashboardSource
lookml = datahub.ingestion.source.looker.lookml_source:LookMLSource
mariadb = datahub.ingestion.source.sql.mariadb.MariaDBSource
metabase = datahub.ingestion.source.metabase:MetabaseSource
mlflow = datahub.ingestion.source.mlflow:MLflowSource
mode = datahub.ingestion.source.mode:ModeSource
mongodb = datahub.ingestion.source.mongodb:MongoDBSource
mssql = datahub.ingestion.source.sql.mssql:SQLServerSource
mysql = datahub.ingestion.source.sql.mysql:MySQLSource
neo4j = datahub.ingestion.source.neo4j.neo4j_source:Neo4jSource
nifi = datahub.ingestion.source.nifi:NifiSource
notion = datahub.ingestion.source.notion.notion_source:NotionSource
okta = datahub.ingestion.source.identity.okta:OktaSource
openapi = datahub.ingestion.source.openapi:OpenApiSource
oracle = datahub.ingestion.source.sql.oracle:OracleSource
postgres = datahub.ingestion.source.sql.postgres:PostgresSource
powerbi = datahub.ingestion.source.powerbi.powerbi:PowerBiDashboardSource
powerbi-report-server = datahub.ingestion.source.powerbi_report_server:PowerBiReportServerDashboardSource
preset = datahub.ingestion.source.preset:PresetSource
presto = datahub.ingestion.source.sql.presto:PrestoSource
presto-on-hive = datahub.ingestion.source.sql.hive.hive_metastore_source:HiveMetastoreSource
pulsar = datahub.ingestion.source.pulsar:PulsarSource
qlik-sense = datahub.ingestion.source.qlik_sense.qlik_sense:QlikSenseSource
redash = datahub.ingestion.source.redash:RedashSource
redshift = datahub.ingestion.source.redshift.redshift:RedshiftSource
s3 = datahub.ingestion.source.s3:S3Source
sac = datahub.ingestion.source.sac.sac:SACSource
sagemaker = datahub.ingestion.source.aws.sagemaker:SagemakerSource
salesforce = datahub.ingestion.source.salesforce:SalesforceSource
sigma = datahub.ingestion.source.sigma.sigma:SigmaSource
slack = datahub.ingestion.source.slack.slack:SlackSource
snaplogic = datahub.ingestion.source.snaplogic.snaplogic:SnaplogicSource
snowflake = datahub.ingestion.source.snowflake.snowflake_v2:SnowflakeV2Source
snowflake-queries = datahub.ingestion.source.snowflake.snowflake_queries:SnowflakeQueriesSource
snowflake-summary = datahub.ingestion.source.snowflake.snowflake_summary:SnowflakeSummarySource
sql-queries = datahub.ingestion.source.sql_queries:SqlQueriesSource
sqlalchemy = datahub.ingestion.source.sql.sql_generic:SQLAlchemyGenericSource
starburst-trino-usage = datahub.ingestion.source.usage.starburst_trino_usage:TrinoUsageSource
superset = datahub.ingestion.source.superset:SupersetSource
tableau = datahub.ingestion.source.tableau.tableau:TableauSource
teradata = datahub.ingestion.source.sql.teradata:TeradataSource
trino = datahub.ingestion.source.sql.trino:TrinoSource
unity-catalog = datahub.ingestion.source.unity.source:UnityCatalogSource
vertexai = datahub.ingestion.source.vertexai.vertexai:VertexAISource
vertica = datahub.ingestion.source.sql.vertica:VerticaSource

[datahub.ingestion.transformer.plugins]
add_dataset_dataproduct = datahub.ingestion.transformer.add_dataset_dataproduct:AddDatasetDataProduct
add_dataset_domain = datahub.ingestion.transformer.dataset_domain:AddDatasetDomain
add_dataset_ownership = datahub.ingestion.transformer.add_dataset_ownership:AddDatasetOwnership
add_dataset_properties = datahub.ingestion.transformer.add_dataset_properties:AddDatasetProperties
add_dataset_tags = datahub.ingestion.transformer.add_dataset_tags:AddDatasetTags
add_dataset_terms = datahub.ingestion.transformer.add_dataset_terms:AddDatasetTerms
domain_mapping_based_on_tags = datahub.ingestion.transformer.dataset_domain_based_on_tags:DatasetTagDomainMapper
extract_dataset_tags = datahub.ingestion.transformer.extract_dataset_tags:ExtractDatasetTags
extract_ownership_from_tags = datahub.ingestion.transformer.extract_ownership_from_tags:ExtractOwnersFromTagsTransformer
mark_dataset_status = datahub.ingestion.transformer.mark_dataset_status:MarkDatasetStatus
pattern_add_dataset_dataproduct = datahub.ingestion.transformer.add_dataset_dataproduct:PatternAddDatasetDataProduct
pattern_add_dataset_domain = datahub.ingestion.transformer.dataset_domain:PatternAddDatasetDomain
pattern_add_dataset_ownership = datahub.ingestion.transformer.add_dataset_ownership:PatternAddDatasetOwnership
pattern_add_dataset_schema_tags = datahub.ingestion.transformer.add_dataset_schema_tags:PatternAddDatasetSchemaTags
pattern_add_dataset_schema_terms = datahub.ingestion.transformer.add_dataset_schema_terms:PatternAddDatasetSchemaTerms
pattern_add_dataset_tags = datahub.ingestion.transformer.add_dataset_tags:PatternAddDatasetTags
pattern_add_dataset_terms = datahub.ingestion.transformer.add_dataset_terms:PatternAddDatasetTerms
pattern_cleanup_dataset_usage_user = datahub.ingestion.transformer.pattern_cleanup_dataset_usage_user:PatternCleanupDatasetUsageUser
pattern_cleanup_ownership = datahub.ingestion.transformer.pattern_cleanup_ownership:PatternCleanUpOwnership
replace_external_url = datahub.ingestion.transformer.replace_external_url:ReplaceExternalUrlDataset
replace_external_url_container = datahub.ingestion.transformer.replace_external_url:ReplaceExternalUrlContainer
set_browse_path = datahub.ingestion.transformer.set_browse_path:SetBrowsePathTransformer
set_dataset_browse_path = datahub.ingestion.transformer.add_dataset_browse_path:AddDatasetBrowsePathTransformer
simple_add_dataset_dataproduct = datahub.ingestion.transformer.add_dataset_dataproduct:SimpleAddDatasetDataProduct
simple_add_dataset_domain = datahub.ingestion.transformer.dataset_domain:SimpleAddDatasetDomain
simple_add_dataset_ownership = datahub.ingestion.transformer.add_dataset_ownership:SimpleAddDatasetOwnership
simple_add_dataset_properties = datahub.ingestion.transformer.add_dataset_properties:SimpleAddDatasetProperties
simple_add_dataset_tags = datahub.ingestion.transformer.add_dataset_tags:SimpleAddDatasetTags
simple_add_dataset_terms = datahub.ingestion.transformer.add_dataset_terms:SimpleAddDatasetTerms
simple_remove_dataset_ownership = datahub.ingestion.transformer.remove_dataset_ownership:SimpleRemoveDatasetOwnership
tags_to_structured_properties = datahub.ingestion.transformer.tags_to_structured_properties:TagsToStructuredPropertiesTransformer
tags_to_term = datahub.ingestion.transformer.tags_to_terms:TagsToTermMapper
